BGGHGG#            @            #GGGGGB
BGGGGG#            @            #GGHGGB
BGGGGG#            @            #GGGGGB
BGGTGG#            @            #GGGGGB
BGGGGG#            @            #GGTGGB
BGGGGG#            @            #GGTGGB
BGGTGG#            @            #GGHGGB
BGGHGG#            @            #GGTGGB
BGGGGG#            @            #GGGGGB
BGGGGG#            @            #GGGGGB
BGGHGG#            @            #GGGGGB
BGGGGG#            @            #GGHGGB
BGGHGG#            @            #GGTGGB
BGGGGG#            @            #GGHGGB
BGGGGG#            @            #GGGGGB
BGGGGG#            @            #GGGGGB
BGGGGG#            @            #GGGGGB
BGGGGG#            @            #GGGGGB
BGGGGG#            @            #GGGGGB
BGGGGG#            @            #GGGGGB
BGGGGG#            @            #GGGGGB
BGGGGG#            @            #GGGGGB
BGGGGG#            @            #GGGGGB
BGGGGG#            @            #GGGGGB
BGGGGG#            @            #GGGGGB
BGGGGG#            @            #GGGGGB
BGGGGG#            @            #GGGGGB
BGGGGG#            @            #GGGGGB
BGGGGG#            @            #GGGGGB
BGGGGG#            @            #GGGGGB
BGGGGG#            @            #GGGGGB
BGGGGG#            @            #GGGGGB
BGGGGG#            @            #GGGGGB
BGGGGG#            @            #GGGGGB
BGGGGG#            @            #GGGGGB
BGGGGG#            @            #GGGGGB
BGGGGG#            @            #GGGGGB
BGGGGG#            @            #GGGGGB
BGGGGG#            @            #GGGGGB
BGGGGG#            @            #GGGGGB
BGGGGG#            @            #GGGGGB
BGGGGG#            @            #GGGGGB
BGGGGG#            @            #GGGGGB
BGGGGG#            @            #GGGGGB
BGGGGG#            @            #GGGGGB
BGGGGG#            @            #GGGGGB
BGGGGG#            @            #GGGGGB
BGGGGG#            @            #GGGGGB
BGGGGG#            @            #GGGGGB
BGGGGG#            @            #GGGGGB
BGGGGG#            @            #GGGGGB
BGGGGG#            @            #GGGGGB
BGGGGG#            @            #GGGGGB
BGGGGG#            @            #GGGGGB
BGGGGG#            @            #GGGGGB
BGGGGG#            @            #GGGGGB
BGGGGG#            @            #GGGGGB
BGGGGG#            @            #GGGGGB
BGGGGG#            @            #GGGGGB
BGGGGG#            @            #GGGGGB
